111111111111111111111111111111111111111111111111111111111111111111111
100100000C0000000000000000000000000C0001111111000000000000001101000E1
100001111100101111101000000000000000100001001100000000000111100000001
110011C00000001000000000000011111100000000000000000000000000C00000101
1111111110000000111000011111111111C00000000000000011111110000100C1111
10000000000C000011100000011111111111110000010100000111111110010011111
1C000000000000000C000011110000000000000111111111111111111111000001111
100000000000C00000000001110111111111110000000000000110000C00000101111
111111100000000001111111110111000000000C00000100000000000000111101111
1C0000000001111100000000000111110010000000111111111110000000000000111
111111111111111111111011110110000000000000000000000011111111111111111
10000000000C000000000001110111111111111000000000000110000000000101111
111111100000000001111111110000000011100000000100000000000000111101111
110000000001111101000000010111110000001000111111111110000000000000111
111111111111111111011111010111110111111101111111111111111111111111111
100000000000000000000001010111110111111000000000000110000000000101111
1111111000000C0001111111010111000000000000C00100000000C00000111101111
110000000001111100000000000111110010000000111110111110000000000000111
111011111111111111111111000111111111101111111110000000011111101111111
10000C000000000000000001110111111111101000000000000110000000000101111
11111110000000000111111111000000000000C000000100000000C00000111101111
1C000000000111110000C001000110110010000000111110111110000000000000111
111111111111111111111011110100000111000000001110111111111110111111111
1000000000000000000000C1110110011111111000000000000110000000000101111
11111110C0000000011111111101110000000000C00001C0000000000000111101111
1P000D00000111110000C000000111110010000000111111111110000C00000000111
111111111111111111111111111111111111111111111111111111111111111111111
