1111111111111
11110000010E1
1110000D00001
1P00000C00001
1111111111111
