1111111111111
11110000000E1
1110000000001
1P00000C00001
1111111111111
